+---+---+---+
|           |
+---+---+   +
|   |       |
+   +   +---+
|           |
+---+---+---+
